1111111111
0000000001
1111101101
1000001101
1101111101
1000000111
1110100001
1000111100
1010100001
1111111111
